111111111111111111111
10PC00000100000CCCCC1
111010010111000111CC1
1010000E00C0000000001
111111111111111111111