111111111111111111111111111111
100001000C00000000000000000001
1000010000000000000000C0000001
10000100000C000000000000000001
100001111111111100000000000001
10000C00000000100000C000000001
100000000000001000000000000001
10000000000P001000011111111111
100000000000001000000000000001
10000000000000100C000000000001
100000000000001000000000000001
100000C00000001000000000000001
1000000000000010000000000000E1
100000000000C00000000000000001
111111111111111111111111111111