111111111111111111111
10PC00000100000CCCCC1
11101001z1110Z0111CC1
1010000E00C0000Z00001
111111111111111111111