111111111
100000E11
1P0000001
111111111