111111111
10000CC11
100E00001
111111111