111111111
1000CCC01
100000001
1000000P1
111111111