111111111
1010P0011
1E1111111
1C1111111
111111111
111111111
